happiness - счастье
happy - счастливый
bliss - блаженство
exultation - ликование
exult - ликовать
joy - радость
gladly - с радостью
rejoice - радоваться
delight - восторг
pleasure - удовольствие
enjoyment - наслаждение
pleased - довольный
cheerful - веселый
carefree - беззаботный
calmness - спокойствие
peace - покой
quiet - тихий
calm down - успокоить
relax - успокоиться
tranquil - безмятежный
interest - интерес
arouse interest - вызывать интерес
interesting - интересный
attractive - привлекательный
interested - заинтересованный
excitement - возбуждение
agitation - волнение
exciting - возбуждающий
thrilling - захватывающий
placid - невозмутимый
compassion - сострадание
sympathy - сочувствие
sympathetic - сочувствующий
sympatize - сочувствовать
pity - жалеть
indifference - безразличие
indifferent - безразличный
apathy - апатия
apathetic - апатичный
boredom - скука
boring - скучный
anger - гнев
in anger - в гневе
fury - ярость
furious - яростный
indignation - негодование
indignant - негодующий
angry - сердитый
infuriate - злить
insult - обида
offend - обидеть
annoyance - досада
resentful - обиженный
anxiety - тревога
trouble - тревожить
worry - беспокоить
troubled - встревоженный
concern - беспокойство
disturbed - очень взволнованный
nervous - нервный
irritate - раздражать
irritated - раздраженный
annoyed - раздосадованный
concerned - озабоченный
tense - напряженный
satisfaction - удовлетворение
satisfy - удовлетворить
contented - довольный
please - угождать
suit - устраивать
dissatisfation - неудовлетворенность
dissatisfied - неудовлетворенный
discintent - недовольство
discontented - недовольный
dissapointment - разочарование
dissapointed - разочарованный
frustrated - глубоко разочарованный
fear - страх
fearful - страшный
terrible - ужасный
fright - испуг
scare - испугать
scared - испуганный
horror - ужас
terrify - ужасать
afraid - бояться
jealousy - ревность
jealous - ревнивый
envy - зависть
envious - завистливый
be envious - завидовать
sadness - грусть
sad - грустный
feel sad - грустить
miss - скучать
sorrow - печаль
heavy-harted - печальный
gloom - уныние
depression - депрессия
gloomy - унылый
cheerless - невеселый
depressed - невеселый
misery - несчастье
miserable - несчастный
unhappy - несчастливый
grief - горе
heartbroken - убитый горем
grieve - переживать
despair - отчаяние
in despair - в отчаянии
pathetic - жалкий
upset - расстроенный
surprise - удивление
surprising - удивительный
wonderful - чудесный
amazing - изумительный
striking - поразительный
great - потрясающий
be surprised - удивляться
astonish - поразить
be astonished - поразиться
amaze - изумлять
stun - ошеломлять
stunning - ошеломляющий

Everything's cool – Все здорово;
I couldn't care less – Мне совершенно безразлично;
I had a complete fit – Меня не на шутку разозлили;
I haven't got a care in the world – Меня ничто не тревожит;
I'm having a really peachy time – Я превосходно провожу время;
I'm on cloud nine – Это просто блаженство;
I'm really buzzing – У меня все просто здорово;
I'm totally over the moon – Я безумно счастлив;
I'm walking on air – Я на седьмом небе от счастья;
I've had the week from hell – У меня была ужасная неделя;
She blew her top – У нее крыша поехала;
She threw a wobbly – Она не в себе;
The fur's been flying – Начались серьезные разногласия;
There's a bad vibe round here – Здесь плохая атмосфера;
We've made it up – Мы все уладили.


Степень выражения чувства:

to love blindly - слепо любить
to love dearly - нежно любить
to love deeply - глубоко любить
to love passionately - страстно любить
to love really, to love very much - сильно любить

LOVE как действие:

to be in love (with) - быть влюбленным (в)
to be out of love (with) - ненавидеть, испытывать отвращение (к), не любить
undying / unrequited love - вечная / безответная любовь
fall in love - влюбляться
fall out of love (with smb.) - разлюбить (кого-л.)
to do smth. with loving care - делать что-л. с любовью
to marry for love - жениться по любви

Другие выражения, связанные с LOVE:

for love - по любви, из-за любви
love at first sight - любовь с первого взгляда
love's young dream - пылкая и безрассудная любовь
blind / limitless / platonic love - слепая / безграничная / платоническая любовь
my love - дорогой, дорогая; любовь моя (обращение)
unrequited love - безответная любовь
loveless - без любви
love-affair - роман, любовная интрига, любовное похождение, любовная связь
amour - любовь; роман. Любовная связь, интрига

LOVE в спорте:

love - спорт. ноль, нулевой счет (особ. в теннисе)
at love - "всухую" (не дав противнику заработать ни очка)
by two to love - со счетом 2:0
love all - "сухая" ничья (счет 0 : 0)

Выражения с LOVE:

all is fair in love and war - в любви и на войне все средства хороши
babe of love (babe (или child) of love) - дитя любви, внебрачный ребенок
be fathoms deep in love - быть безумно влюблённым; быть влюблённым по уши
calf love - детская влюблённость, юношеское увлечение
cupboard love - корыстная любовь, любовь с расчётом
love cannot be compelled (love cannot be compelled (или forced)) - насильно мил не будешь
love in a cottage - с милым рай и в шалаше
love is never without jealousy - нет любви без ревности
love is the mother of love (love is the mother of love (love begets love)) - любовь порождает (ответную) любовь
what a love of a child / man / dress - что за прелесть! (о ребенке, человеке, платье и т. д.)